11111111
11011110
11011111
01011011
01110100
10011110
01111111
01111111