00000000
11111110
01111110
01000000
00000011
10011010
01001000
01111110