11000111
11011110
00011111
01011011
01110111
10011110
01111111
01111111