00111110
10011100
10101010
10011000
11000110
11100010
11100000
11111100