0000000000
0010000101
0100000000
0100001100
0110010010
1000110010
0000100101
0100100010
1000010000
0101100000