1111111111
1101111010
1101111111
0101101100
0111010010
1001111010
0000111101
0111100010
1001010000
0101111111