1110111111
1101011010
1100001111
0101101100
0111010010
1001111010
0000111101
0111100010
1001010000
0101111111