0100100010
0001010010
1001010000
0100100100
0001010010
1001000011