0010100111
1000000001
1110001100
1100011110
1111001100
0011001110
0000011111
1100000101
1110000110
1001010000