0000000000
1111110111
1111100111
1111000111
1111011111
1111000111
1111000110
1111110001
1111111100
1111111110