1111100001
0100100000
0110110000
0010011000
0011001000
0001001000
0111001110
0100110010
0100110010
0111011111